111111111111
100011CCCC01
100001111001
1P0011E00001
111111111111