1111111111111111111111
100010CCCC000000000001
1000011110000000000001
1P00110000000000000111
10000000000000000001E1
1111111111111111111111